444444444444444444444444
100000000000006000060002
100005050500006002060102
100000000000006002060102
100005050500006002060102
100000000000006002000102
100000000000006002222243
100000000000000000000003
100000000000000000000003
100000000000000000000003
100000333333333000000003
100000300000003000000003
100000300000003000000001
100000300000003000000002
100000333303333000000003
100000000303000000000004
100000000303000000000005
100000000000000000000006
100000000000000000000003
100000000000000000000003
100000000000000000000003
100000000000000000000003
100000000000000000000003
222222222222222222222222